30
30
PPPPPPPPPPPPPPPPPPPPPPPPPPPPPP
PPPPPPPPPPPPPPPPPPPPPPPPPPPPPP
PPPPPPPPPPPPPPPPPPPPPPPPPPPPPP
PPPSSSSSSSSSSSMMMMMMMMMMMMMPPP
PPPSSMMMMMMMMSMSSSSSMMMMMSMPPP
PPPSSSABSMMMMSMSSSSSMAAAMSMPPP
PPPMMMMMSSSMMSMSSSSSMADAMSMPPP
PPPMSSSMSSSMMSMSSSSSMMSMMMMPPP
PPPMSSSMSSSMMSMMMMMMMMSMSSSPPP
PPPMSSSMMSMMMSBBBBBBBBSASSSPPP
PPPMSMMMMSMSMSMMMMMMMMSMSSSPPP
PPPMSMSSSSMSMSMMMMMMMBSBMMMPPP
PPPMSMSMMMMSMSMMMMMMMBKBMSMPPP
PPPMSMSMSSSSMSMMMMSSSMMMMSMPPP
PPPMSMSMMMMMMSMMMMSDSMSSSSMPPP
PPPMSMSMMAAAMSMMMMSSSMSSSSMPPP
PPPMSMSSSAXSSSMMMMMSMMSMMMMPPP
PPPMSMSMMAAAMSMMMMMSMMMMAAAPPP
PPPMSMSMMMMMMSAAAAASAAAAAAAPPP
PPPMSMSMSSSSMSMMMMMSMMMMAAAPPP
PPPMSMSMMMMMMSBBBBBSMMSMMMMPPP
PPPMSMSMMBBBMSMMMMSSSMSSSSMPPP
PPPMSMSMMBKSSSMSSMSKSMSSSSMPPP
PPPMSMSMMBBBMSMSSMSSSMSSSSMPPP
PPPMSMSMMMMMMSMMSMMMMMSSSSMPPP
PPPMSMSMMMMMSSSMSSSSSSSSSSMPPP
PPPMMMSSSSSSSSSMMMMMMMMMMMMPPP
PPPPPPPPPPPPPPPPPPPPPPPPPPPPPP
PPPPPPPPPPPPPPPPPPPPPPPPPPPPPP
PPPPPPPPPPPPPPPPPPPPPPPPPPPPPP
